full stack web developer - givebutter internship - handshake
data analyst internship - gradsiren - handshake
analyst - bbg - handshake
spring/summer intern - global alternative research firm - handshake
it/ business technology - viatech publishing solutions - hanshakes
data analyst intern - healthcare highways inc. - handshake
quality control analyst - direct access capital - handshake
information technology, software engineer, quality intern - texas instruments - website

ruby Web Developer (indeed easy apply)
-----------------------
Lignum Custom Design - Miami, FL
QA Intern - Videri - New York, NY
Software Developer - EV Technologies - Brookings, SD
Software Engineering Intern - SimplyInsured - San Francisco, CA
Software Co-Op Engineer - May 2019 - CoverMyMeds5 reviews - Columbus, OH
Ruby on Rails Software Engineering Intern - Lawgix Inc - Austin, TX
Software Engineer Intern - NextCapital - Chicago, IL
Software Engineer-Intern - Neat Work2 reviews - Salt Lake City, UT
Remote Full Stack Application Developer Partner/Intern - Elevate Creative - New York, NY

Handshake
726-1448 - Software Quality Assurance (QA) Intern. -Copart
 723-1982 - Systems Engineer Intern. -copart
Data Science Specialist â€“ Technology Intern (Houston, TX) - BP
Front End Developer - Infly Investments LLC
Software Engineering Interns - Spring/Summer/ Fall 2019 - Call-Em-All
Computer Security Specialist / IT Security - Infly Investments LLC
CRM Development Intern - Summit Financial Group, Inc.
2019 Summer Programming Internship - USAA Real Estate
Internship Program - Software Developer Intern - Epsilon
Internship Program - Security Operations Intern - Epsilon
Software Developer Intern - Advanced Threat Analytics
